wwwwwwwwwwwwwwwwwwwwwwwwww
w-------c--A-------------w
w-------------c----------w
w------------------------w
w------------------------w
w------------------------w
w------------------------w
w------------------------w
w------------------------w
w------------------------w
w------------------------w
w---e--------------------w
wwwwwwwwwwwwwwwwwwwwwwwwww
