wwwwwwwwwwwwwwwwwwwwwwwwww
w-----c----A--w----------w
w-------------w----------w
w----------e--w----------w
wwwwwwwwwwwwwww----------w
w------------------------w
w------------------------w
w------------------------w
w------------------------w
w------------------------w
w------------------------w
w-------------------e----w
wwwwwwwwwwwwwwwwwwwwwwwwww
